WWWWWWWWWWWWWWWWWWWWW
WGGGGGGGGGGGGGGGGGGWW
WGGGGGGGGGGGGGGGGGGWW
WGGGGGGGGGGGGGGGGGRWW
WGFGGGGGGGGGGGGGGGGGG
WGGGGGGGGGGGGGGGGGGWW
WGGGGGFGGGGGGGGGGGGWW
WGGGGGGGGGGGGGGNWWWWW
WGGGGGGGGGGGGGGGGGGGG
WGGGGGGGGGGGGGGGGGGGG
WGGGGGGGGGGGGGGGGGGWW
WGGGGGGGGGFGGGGGGGEWW
WGGGGGGGGGGGGGGGGGGWW
WGGGGGGGGGGGGGGGGGJWW
WGGGGGGGGGGRWGGGGEWWW
WGGGGGGGGGGGGGGGGGGWW
WGGGGGGGGGGGGGGGGGGWW
WGGGGGGGGGGGGGGTWEGWW
WGGGGGGGGGGGGGGGGGGWW
WGGGGGGGGGGGGGGGGGNWW
WGGGGFGGGGGGGGGGGGGWW
WGGGGGGGGGGGGGGGGGEWW
WGGGGGGGGGGGGGGGGGJWW
WGGGGGGGFGGGGGGGGGGWW
WGGGGGGGGGGGGRGGGGGWW
WGGGGGGGGGGGGGGGGGWWW
WGGGGFGGGGGGGGGGGWWWW
WGGGGGGGGGGGGGGGWWWWW
WGGGGGGGGGGGGGGGGGGGG
WGGGGGGGGGGGGGGGGGGGG
WGGGGGGGGGGGGGGGGGGGG
WGGGGGGGGGGGGGGGGGEWW
WGGGGFGGGGGGGGGGGGGWW
WGGGGGGNGGGGGGGGGGTWW
WGGGGFGGGGGGGGGGGGGWW
WGGGGGGGGGGGGGGGGGGWW
WGGGGGGGGGGGGGGGGGGGG
WGGGGGGGGGGGGGWWGGGWW
WGGGGGGGGGGGGGGWGGGWW
WGGGGGGGGGFGGGGGGGEWW
WGGGGGGGGGGGGGGGGGGWW
WGGGGGGGGGGGGGGGGGJWW
WGGGGGGGGGGRWGGGGGGWW
WGGGGGGGGGGGGGGGGGGWW
WGGGGGGGGGGGGGGGGGGWW
WGGGGGGGGGGGGGGGWEGWW
WGGGGGGGGGGGGGGGGGGWW
WGGGGGGGGGGGGGGGGGNWW
WGGGGGGGGGGGGGGGGGEWW
WGGGGGGGGGGGGGGGWWWWW
PPPPPPPPPPPPPPPPPPPPP




