WWWWWWWWWWWWWWWWWWWWW
WGGGGGGGGGGGGGGGGGGWW
WGGGGGGGGGGGGGGGGGGWW
WWWWGGGGGGGGGGGGWGGGG
WGGGGGGGGGGGEGGGWGGGG
WGGGGGGGGGGGGGGGWGTGG
WGGGGGGGGGGGGGGGWGGGG
WGGGGGGGGGGGGGGGGGGGG
WGGGGGGGGGGGGGGGGGGWG
WGGGGGGGGGGGGGGGGGGWW
WGGGGGGGGGGBGGGGGGNWW
WGGGGGGGGGFGGGGGGGEWW
WGGGGGGGGGGGGGGGGGGWW
WGGGGGGGBGGGGGGGGGJWW
WGGGGGGGGGGGGGGGGGEWW
WGGGGGGGGGGGGGGGGGEWW
WGGGGGGGGGGGGGBGGGGWW
WGGGGGGGGGGGGGGTWEGWW
WGGGGGGGGGGGGGGGGGGWW
WGGGGGGGGGGGGGGGGGNWW
WGGGGGGGGGGGGGGGGGGWW
WGGGGGGGGGGGGGGGGGGWW
WGGGGGGGGGGGGGGGGGGWW
WGGGGGGGGGGGGGGGGGNWW
WGGGGGGGGGGGGRGGGGEWW
WGGGGGGGGFGGGGGGGGRWW
WGGGGGGGGGGGGGGGGGWWW
WGGGGGGGGGGGGGGGWWWWW
WGGGGGGGGGGGGGGGGGGGG
WGGGGGGGGGGGGGGGGGBGG
WGGGGGGGGGGGGGGGGGGWW
WGGGGGGGGGGGGGGGGGGWW
WGGGGGGGGGGGGBGGGGGWW
WGGGGGGNGGFGGBGGGGTWW
WGGGGFGGGGGGGGGGGGGWW
WGGGGGGGGGGGGGGGGGWWW
WGGGGGGGGGGGGGGGGGWGG
WGGGGGGGGGGGGGGGGGGWW
WGGGGGGGGGGGGGGGGGNWW
WGGGGGGGGGFGGGGGGGEWW
WGGGGGGGGGGGGGGGGGEWW
WGGGGGGGGGGGGGGGGGJWW
WGGGGGGGGGGRWGGGGGGWW
WGGGGGGGGGGGGGGGGGGWW
WGGGGGGGGGGGGGGGGGGWW
WGGGGGGGGGGGGGGGWEGWW
WGGGGGGGGGGGGGGGGGGWW
WGGGGGGGGGGGGGGGGGNWW
WGGGGGGGGGGGGGGGGGGWW
WGGGGGGGGGGGGGGGGGGWW
PPPPPPPPPPPPPPPPPPPPP




