WWWWWWWWWWWWWWWWWWWWW
WGGGGGGGGGGGGGGGGGGWW
WGGGGGGGGGGGGGGGGGGWW
WGGGGGGGGGGGGGGGGGGWW
WGGGGGGGGGGGEGGGGGGWW
WGGGGGGGGGGGGGGGGGTWW
WGGGGGGGGGGGGGGGGGEWW
WGGGGGGGGGGGGGGGGEWWW
WGGGGGGGGGGGGGGGGGGGG
WGGGGGGGGGGGGGGGGGGGG
WGGGGGGGGGGGGGGGGGNWW
WGGGGGGGGGFGGGGGGGEWW
WGGGGGGGGGGGGGGGGGGWW
WGGGGGGGGGGGGGGGGGJWW
WGGGGGGGGGGGRGGGGGGWW
WGGGGGGGGGGGGGGWWWWWW
WGGGGGGGGGGGGGGGGGGWW
WGGGGGGGGGGGGGGGGGGWW
WGGGGGGGGGGGGGGGGGJWW
WGGGGGGGGGGGGGGGGGNWW
WGGGGGGGGGGGGGGGGGEWW
WGGGGGGGGGGGGGGWWWWWW
WGGGGGGGGGGGGGGGGGGGG
WGGGGGGGGGGGGGGGGGGGG
WGGGFGGGGGGGGRWGGGEWW
WGGGGGGGGGGGGGGGGGEWW
WGGGGGGGGGGGGGGGGGEWW
WGGGGGGGGGGGGGGGWWEWW
WGGGGGFGGGGGGGGGGGGGG
WGGGGGGGGGGGGGGGGGGGG
WGGGGGGGGGGGGGGGGGGWW
WGGGGGGGGGGGGWGGGGGWW
WGGGGGGGGGGGEWGGGGEWW
WGGGGGGNGGGGGWGGGGTWW
WGGGGFGGGGGGGGGGGGGWW
WGGGGGGGGGGGGGGGGGWWW
WGGGGGGGGGGGGGGGGGGGG
WGGGGGGGGGGGGGWGGGGWW
WGGGGGGGGGGGGGGWGGNWW
WGGGGGGGGGFGGGGGGGEWW
WGGGGGGGGGGGGGGGGGGWW
WGGGGGGGGGGGGGGGGGJWW
WGGGGGFGGGGRWGGGGGGWW
WGGGGGGGGGGGGGGGGGGWW
WGGGGGGGGGGGGGGGGGEWW
WGGGGGGGGGGGGGGGGGGGG
WGGGGGGGGGGGGGGGGGGWW
WGGGGGGGGGGGGGGGGGNWW
WGGGGGGGGGGGGGGWWWWWW
WGGGGGGGGGGGGWWWWWWWW
PPPPPPPPPPPPPPPPPPPPP




