WWWWWWWWWWWWWWWWWWWWW
WGGGGGGGGGGGGGGGGGGWW
WGGGGGGGGGGGGGGGGGGWW
WWWWGGGGGGGGGGGGGGGWW
WGGGGGGGGGGGEGGGGGGWW
WGGGGGGGGGGGGGGGGGTWW
WGGGGGGGGGGGGGGGGGGWW
WGGGGGFGGGGGGGGGGGWWW
WGGGGGGGGGGGGGGGGGGBG
WGGGGGGGGGGGGGGGGGGWW
WGGGGGGGGGGGGGGGGGJWW
WGGGGGGGGGFGGGGGGGEWW
WGGGGGGGGGGGGGGGGGGWW
WGGGGGGGGGGGGGGGGGJWW
WGGGGGGGGGGWBGGGGGGWW
WGGGGGGGGGGGGGGGGGGWW
WGGGGGGGGGGGGGGGGGEWW
WGGGGGGGGGGGGGGGWEGWW
WGGGGGGGGGGGGGGGGGGWW
WGGGGGGGGGGGGGGGGGNWW
WGGGGGGGGGGGGGGGGGGWW
WGGGGGGGGGGGGGGGGGGWW
WGGGGGGGGGGFGGGGGGGWW
WGGGGGGGGGGFGGGGGGGWW
WGGGGGGGGGGGGRGGGGGWW
WGGGGGGGGGGGGGGGGGGWW
WGGGGGGGGGGGGGGGGGGWW
WGGGGGGGGGGGGGGTWWRWW
WGGGGGGGGGGGGGGGGGWGG
WGGGGGGGGGGGGGGGGGWGG
WGGGGGGGGGGGGGGGGGGWW
WGGGGGGGGGGGGGGGGGGGG
WGGGGGGGGGGGFGGGGGGWW
WGGGGGGNGGGGGGGGGGTGG
WGGGGFGGGGGGGGGGGGGWW
WGGGGGGGGGGGGGGGGGGWW
WGGGGGGGGGGGGGGGGGGGG
WGGGGGGGGGGGGGGGGGGWW
WGGGGGGGGGGGGGGGGGNWW
WGGGGFGGGGGGGGGGGGEWW
WGGGGGGGGGGGGGGGGGGWW
WGGGGGGFGGGGGGGGGGJWW
WGGGGGGGGGGEWGGGGGGWW
WGGGGGGGGGGGGGGGEGGWW
WGGGGGGGGGGGGGGGGGGWW
WGGGGFGGGGJGGGGGWEGWW
WGGGGGGGGGGGGGGGGGGWW
WGGGGGGGGGGGGGGGGWWWW
WGGGGGGGGGGGGGGWWWWWW
WGGGGGGGGGGGWWWWWWWWW
PPPPPPPPPPPPPPPPPPPPP




